11111111111111111111111111111
1000P000000111111111111110001
10110000011111111110000000C01
1010001001111000C000000000001
100C0100000000000000000000001
10000100011111111000000000C01
10000011110000001000000000001
10000000000000001000000000E01
11111111111111111111111111111