1111111111111111111111111111111111111111
1000000000000000000000000000000000000001
1000000011111111111111100000000000000001
1000000000000000E00000000000100000000001
1000000000000000P00011100000C11100000001
100CCCCCCCCCCCCCCCCCC1000000100000000001
1000000000000000CC0001000000000000000001
1111111111111111111111111111111111111111
